%%%%%%%%%%%%%%%%%%%%%
%....%.... ....%....%
%.%%.%.%%%%%%%.%.%%.%
%......... .........%
%%.%.%%.%%%%%.%%.%.%%
%..%...... ......%..%
%%.%%%%.%% %%.%%%%.%%
%%......%   %......%%
%%.%%%%.%%%%%.%%%%.%%
%..%......P......%..%
%%.%.%.%.%%%.%.%.%.%%
%....%.%.. ..%.%....%
%.%% %...%%%...%.%%.%
%.%%.%%%.%%%.%%%.%% %
%......... .........%
%%%%%%%%%%%%%%%%%%%%%
