%%%%%%%%%%%%%%%%%%%%%
%.... .... .... ....%
%.  . .       . .  .%
%......... .........%
% . .  .     .  . . %
%.. ...... ...... ..%
% .    .     .    . %
% ......     ...... %
% .    .     .    . %
%.. ......P...... ..%
% . . . .   . . . . %
%.... . .. .. . ....%
%.    ...   ... .  .%
%.  .   .   .   .   %
%......... .........%
%%%%%%%%%%%%%%%%%%%%%
